NO ./src/texture/no.xpm
SO ./src/texture/so.xpm
EA ./src/texture/ea.xpm
WE ./src/texture/we.xpm

C 200,196,222
F 150,97,42

        1111111111111111111111111
111111111100000000110000000000001
111111111011000001110000000000001111111111111111111111111111111
111111111001000000100000000000001
111111111011000001110000000000001
100000000011000001110111111111111
111101111111110111000000100011111
11110111111111011101010010001
110000001101010111000000100011111
100000000000S00011000000111111111
100000000000000011010100110001111
110000011101010111110111110001111
111101111111010111011110110001111
111111111111111111111111111111111
