NO ./src/texture/no.xpm
SO ./src/texture/so.xpm
EA ./src/texture/ea.xpm
WE ./src/texture/we.xpm

C 225,255,0
F 220,100,0

111111111111111111111111111111111
111111111100000000110000000000001
111111111011000001110000000000001
111111111001000000100000000000001
111111111011000001110000000000001
100000000011000001110111111111111
111101111111110111000000100011111
111101111111110111010100100011111
110000001101010111000000100011111
100000000000000011000000100011111
100000000000S00011010100100011111
110000011101010111110111100011111
111101111111010111011110100011111
111111111111111111111111111111111
