



NO ./src/texture/no
SO /Users/dilopez-/a




























































































WE   src/texture/we





EA                              ./src/texture/ea

F                                255,255,255+1-1
C                                                                                2c5,30*1,20-1
1            
        1111111111111111111111111
        1000110000110000000000001
        1011000001010000000000001
        1001000000000000000000001
111111111011000001110000000000001
100000000011000001110111111111111
1111011111111101110000010001                                                                                                                                                                  111111111111111111111111111111111111
1111111111111011101010010001
11000000110101011100000010001                        11111111
10000000000000001100000010001           111111111111
10000000000000001101010010001                  11111111111111111
110000011101010111110W1111000111
11110111 1110101 101111010001         11111111111
11111111 1111111 111111111111111                        1111111111
1111111111111111111111111111111111           1111111111
1111111111111111111111111111111111     11111111111
        1111111111111111111111111
        1000000000110000000000001
        1011000001010000000000001
        10010000000000000000000011
111111111011000001110000000000001
100000000011000001110111111111111
1111011111111101110000010001                                     111111111111111111111111111111111111
11110111111111011101010010001
11000000110101011100000010001                        11111111
10000000000000001100000010001           111111111111
100NNNNNN00000001101010010001                  11111111111111111
110000011101010111110W1111000111
11110111 1110101 101111010001         11111111111
11111111 1111111 111111111111111                        1111111111
1111111111111111111111111111111111           1111111111
1111111111111111111111111111111111     11111111111
 1
 1
101
 1
 11111111111111111111111111111111111111111111111111111111     11111111111
        1111111111111111111111111
        1000000000110000000000001
        1011000001010000000000001
        10010000000000000000000011
111111111011000001110000000000001
100000000011000001110111111111111
1111011111111101110000010001                                     111111111111111111111111111111111111
11110111111111011101010010001
11000000110101011100000010001                        11111111
10000000000000001100000010001           111111111111
100NNNNNN00000001101010010001                  11111111111111111
110000011101010111110W1111000111
11110111 1110101 101111010001         11111111111
11111111 1111111 111111111111111                        1111111111
1111111111111111111111111111111111           1111111111
1111111111111111111111111111111111     11111111111
 1
 1
101
 1111111111111111111111111111111111     11111111111
        1111111111111111111111111
        1000000000110000000000001
        1011000001010000000000001
        10010000000000000000000011
111111111011000001110000000000001
100000000011000001110111111111111
1111011111111101110000010001                                     111111111111111111111111111111111111
11110111111111011101010010001
11000000110101011100000010001                        11111111
10000000000000001100000010001           111111111111
100NNNNNN00000001101010010001                  11111111111111111
110000011101010111110W1111000111
11110111 1110101 101111010001         11111111111
11111111 1111111 111111111111111                        1111111111
1111111111111111111111111111111111           1111111111
1111111111111111111111111111111111     11111111111
 1
 1
101
 1111111111111111111111111111111111     11111111111
        1111111111111111111111111
        1000000000110000000000001
        1011000001010000000000001
        10010000000000000000000011
111111111011000001110000000000001
100000000011000001110111111111111
1111011111111101110000010001                                     111111111111111111111111111111111111
11110111111111011101010010001
11000000110101011100000010001                        11111111
10000000000000001100000010001           111111111111
100NNNNNN00000001101010010001                  11111111111111111
110000011101010111110W1111000111
11110111 1110101 101111010001         11111111111
11111111 1111111 111111111111111                        1111111111
1111111111111111111111111111111111           1111111111
1111111111111111111111111111111111     11111111111
 1
 1
101
 1111111111111111111111111111111111     11111111111
        1111111111111111111111111
        1000000000110000000000001
        1011000001010000000000001
        10010000000000000000000011
111111111011000001110000000000001
100000000011000001110111111111111
1111011111111101110000010001                                     111111111111111111111111111111111111
11110111111111011101010010001
11000000110101011100000010001                        11111111
10000000000000001100000010001           111111111111
100NNNNNN00000001101010010001                  11111111111111111
110000011101010111110W1111000111
11110111 1110101 101111010001         11111111111
11111111 1111111 111111111111111                        1111111111
1111111111111111111111111111111111           1111111111
1111111111111111111111111111111111     11111111111
 1
 1
101
 1111111111111111111111111111111111     11111111111
        1111111111111111111111111
        1000000000110000000000001
        1011000001010000000000001
        10010000000000000000000011
111111111011000001110000000000001
100000000011000001110111111111111
1111011111111101110000010001                                     111111111111111111111111111111111111
11110111111111011101010010001
11000000110101011100000010001                        11111111
10000000000000001100000010001           111111111111
100NNNNNN00000001101010010001                  11111111111111111
110000011101010111110W1111000111
11110111 1110101 101111010001         11111111111
11111111 1111111 111111111111111                        1111111111
1111111111111111111111111111111111           1111111111
1111111111111111111111111111111111     11111111111
 1
 1
101
 1111111111111111111111111111111111     11111111111
        1111111111111111111111111
        1000000000110000000000001
        1011000001010000000000001
        10010000000000000000000011
111111111011000001110000000000001
100000000011000001110111111111111
1111011111111101110000010001                                     111111111111111111111111111111111111
11110111111111011101010010001
11000000110101011100000010001                        11111111
10000000000000001100000010001           111111111111
100NNNNNN00000001101010010001                  11111111111111111
110000011101010111110W1111000111
11110111 1110101 101111010001         11111111111
11111111 1111111 111111111111111                        1111111111
1111111111111111111111111111111111           1111111111
1111111111111111111111111111111111     11111111111
 1
 1
101
 1111111111111111111111111111111111     11111111111
        1111111111111111111111111
        1000000000110000000000001
        1011000001010000000000001
        10010000000000000000000011
111111111011000001110000000000001
100000000011000001110111111111111
1111011111111101110000010001                                     111111111111111111111111111111111111
11110111111111011101010010001
11000000110101011100000010001                        11111111
10000000000000001100000010001           111111111111
100NNNNNN00000001101010010001                  11111111111111111
110000011101010111110W1111000111
11110111 1110101 101111010001         11111111111
11111111 1111111 111111111111111                        1111111111
1111111111111111111111111111111111           1111111111
1111111111111111111111111111111111     11111111111
 1
 1
101
 1111111111111111111111111111111111     11111111111
        1111111111111111111111111
        1000000000110000000000001
        1011000001010000000000001
        10010000000000000000000011
111111111011000001110000000000001
100000000011000001110111111111111
1111011111111101110000010001                                     111111111111111111111111111111111111
11110111111111011101010010001
11000000110101011100000010001                        11111111
10000000000000001100000010001           111111111111
100NNNNNN00000001101010010001                  11111111111111111
110000011101010111110W1111000111
11110111 1110101 101111010001         11111111111
11111111 1111111 111111111111111                        1111111111
1111111111111111111111111111111111           1111111111
1111111111111111111111111111111111     11111111111
 1
 1
101
 1111111111111111111111111111111111     11111111111
        1111111111111111111111111
        1000000000110000000000001
        1011000001010000000000001
        10010000000000000000000011
111111111011000001110000000000001
100000000011000001110111111111111
1111011111111101110000010001                                     111111111111111111111111111111111111
11110111111111011101010010001
11000000110101011100000010001                        11111111
10000000000000001100000010001           111111111111
100NNNNNN00000001101010010001                  11111111111111111
110000011101010111110W1111000111
11110111 1110101 101111010001         11111111111
11111111 1111111 111111111111111                        1111111111
1111111111111111111111111111111111           1111111111
1111111111111111111111111111111111     11111111111
 1
 1
101
 1111111111111111111111111111111111     11111111111
        1111111111111111111111111
        1000000000110000000000001
        1011000001010000000000001
        10010000000000000000000011
111111111011000001110000000000001
100000000011000001110111111111111
1111011111111101110000010001                                     111111111111111111111111111111111111
11110111111111011101010010001
11000000110101011100000010001                        11111111
10000000000000001100000010001           111111111111
100NNNNNN00000001101010010001                  11111111111111111
110000011101010111110W1111000111
11110111 1110101 101111010001         11111111111
11111111 1111111 111111111111111                        1111111111
1111111111111111111111111111111111           1111111111
1111111111111111111111111111111111     11111111111
 1
 1
101
 1111111111111111111111111111111111     11111111111
        1111111111111111111111111
        1000000000110000000000001
        1011000001010000000000001
        10010000000000000000000011
111111111011000001110000000000001
100000000011000001110111111111111
1111011111111101110000010001                                     111111111111111111111111111111111111
11110111111111011101010010001
11000000110101011100000010001                        11111111
10000000000000001100000010001           111111111111
100NNNNNN00000001101010010001                  11111111111111111
110000011101010111110W1111000111
11110111 1110101 101111010001         11111111111
11111111 1111111 111111111111111                        1111111111
1111111111111111111111111111111111           1111111111
1111111111111111111111111111111111     11111111111
 1
 1
101
 1111111111111111111111111111111111     11111111111
        1111111111111111111111111
        1000000000110000000000001
        1011000001010000000000001
        10010000000000000000000011
111111111011000001110000000000001
100000000011000001110111111111111
1111011111111101110000010001                                     111111111111111111111111111111111111
11110111111111011101010010001
11000000110101011100000010001                        11111111
10000000000000001100000010001           111111111111
100NNNNNN00000001101010010001                  11111111111111111
110000011101010111110W1111000111
11110111 1110101 101111010001         11111111111
11111111 1111111 111111111111111                        1111111111
1111111111111111111111111111111111           1111111111
1111111111111111111111111111111111     11111111111
 1
 1
101
 1111111111111111111111111111111111     11111111111
        1111111111111111111111111
        1000000000110000000000001
        1011000001010000000000001
        10010000000000000000000011
111111111011000001110000000000001
100000000011000001110111111111111
1111011111111101110000010001                                     111111111111111111111111111111111111
11110111111111011101010010001
11000000110101011100000010001                        11111111
10000000000000001100000010001           111111111111
100NNNNNN00000001101010010001                  11111111111111111
110000011101010111110W1111000111
11110111 1110101 101111010001         11111111111
11111111 1111111 111111111111111                        1111111111
1111111111111111111111111111111111           1111111111
1111111111111111111111111111111111     11111111111
 1
 1
101
 1111111111111111111111111111111111     11111111111
        1111111111111111111111111
        1000000000110000000000001
        1011000001010000000000001
        10010000000000000000000011
111111111011000001110000000000001
100000000011000001110111111111111
1111011111111101110000010001                                     111111111111111111111111111111111111
11110111111111011101010010001
11000000110101011100000010001                        11111111
10000000000000001100000010001           111111111111
100NNNNNN00000001101010010001                  11111111111111111
110000011101010111110W1111000111
11110111 1110101 101111010001         11111111111
11111111 1111111 111111111111111                        1111111111
1111111111111111111111111111111111           1111111111
1111111111111111111111111111111111     11111111111
 1
 1
101
 1111111111111111111111111111111111     11111111111
        1111111111111111111111111
        1000000000110000000000001
        1011000001010000000000001
        10010000000000000000000011
111111111011000001110000000000001
100000000011000001110111111111111
1111011111111101110000010001                                     111111111111111111111111111111111111
11110111111111011101010010001
11000000110101011100000010001                        11111111
10000000000000001100000010001           111111111111
100NNNNNN00000001101010010001                  11111111111111111
110000011101010111110W1111000111
11110111 1110101 101111010001         11111111111
11111111 1111111 111111111111111                        1111111111
1111111111111111111111111111111111           1111111111
1111111111111111111111111111111111     11111111111
 1
 1
101
 1111111111111111111111111111111111     11111111111
        1111111111111111111111111
        1000000000110000000000001
        1011000001010000000000001
        10010000000000000000000011
111111111011000001110000000000001
100000000011000001110111111111111
1111011111111101110000010001                                     111111111111111111111111111111111111
11110111111111011101010010001
11000000110101011100000010001                        11111111
10000000000000001100000010001           111111111111
100NNNNNN00000001101010010001                  11111111111111111
110000011101010111110W1111000111
11110111 1110101 101111010001         11111111111
11111111 1111111 111111111111111                        1111111111
1111111111111111111111111111111111           1111111111
1111111111111111111111111111111111     11111111111
 1
 1
101
 1111111111111111111111111111111111     11111111111
        1111111111111111111111111
        1000000000110000000000001
        1011000001010000000000001
        10010000000000000000000011
111111111011000001110000000000001
100000000011000001110111111111111
1111011111111101110000010001                                     111111111111111111111111111111111111
11110111111111011101010010001
11000000110101011100000010001                        11111111
10000000000000001100000010001           111111111111
100NNNNNN00000001101010010001                  11111111111111111
110000011101010111110W1111000111
11110111 1110101 101111010001         11111111111
11111111 1111111 111111111111111                        1111111111
1111111111111111111111111111111111           1111111111
1111111111111111111111111111111111     11111111111
 1
 1
101
 1111111111111111111111111111111111     11111111111
        1111111111111111111111111
        1000000000110000000000001
        1011000001010000000000001
        10010000000000000000000011
111111111011000001110000000000001
100000000011000001110111111111111
1111011111111101110000010001                                     111111111111111111111111111111111111
11110111111111011101010010001
11000000110101011100000010001                        11111111
10000000000000001100000010001           111111111111
100NNNNNN00000001101010010001                  11111111111111111
110000011101010111110W1111000111
11110111 1110101 101111010001         11111111111
11111111 1111111 111111111111111                        1111111111
1111111111111111111111111111111111           1111111111
1111111111111111111111111111111111     11111111111
 1
 1
101
 1111111111111111111111111111111111     11111111111
        1111111111111111111111111
        1000000000110000000000001
        1011000001010000000000001
        10010000000000000000000011
111111111011000001110000000000001
100000000011000001110111111111111
1111011111111101110000010001                                     111111111111111111111111111111111111
11110111111111011101010010001
11000000110101011100000010001                        11111111
10000000000000001100000010001           111111111111
100NNNNNN00000001101010010001                  11111111111111111
110000011101010111110W1111000111
11110111 1110101 101111010001         11111111111
11111111 1111111 111111111111111                        1111111111
1111111111111111111111111111111111           1111111111
1111111111111111111111111111111111     11111111111
 1
 1
101
 1111111111111111111111111111111111     11111111111
        1111111111111111111111111
        1000000000110000000000001
        1011000001010000000000001
        10010000000000000000000011
111111111011000001110000000000001
100000000011000001110111111111111
1111011111111101110000010001                                     111111111111111111111111111111111111
11110111111111011101010010001
11000000110101011100000010001                        11111111
10000000000000001100000010001           111111111111
100NNNNNN00000001101010010001                  11111111111111111
110000011101010111110W1111000111
11110111 1110101 101111010001         11111111111
11111111 1111111 111111111111111                        1111111111
1111111111111111111111111111111111           1111111111
1111111111111111111111111111111111     11111111111
 1
 1
101
 1111111111111111111111111111111111     11111111111
        1111111111111111111111111
        1000000000110000000000001
        1011000001010000000000001
        10010000000000000000000011
111111111011000001110000000000001
100000000011000001110111111111111
1111011111111101110000010001                                     111111111111111111111111111111111111
11110111111111011101010010001
11000000110101011100000010001                        11111111
10000000000000001100000010001           111111111111
100NNNNNN00000001101010010001                  11111111111111111
110000011101010111110W1111000111
11110111 1110101 101111010001         11111111111
11111111 1111111 111111111111111                        1111111111
1111111111111111111111111111111111           1111111111
1111111111111111111111111111111111     11111111111
 1
 1
101
 1111111111111111111111111111111111     11111111111
        1111111111111111111111111
        1000000000110000000000001
        1011000001010000000000001
        10010000000000000000000011
111111111011000001110000000000001
100000000011000001110111111111111
1111011111111101110000010001                                     111111111111111111111111111111111111
11110111111111011101010010001
11000000110101011100000010001                        11111111
10000000000000001100000010001           111111111111
100NNNNNN00000001101010010001                  11111111111111111
110000011101010111110W1111000111
11110111 1110101 101111010001         11111111111
11111111 1111111 111111111111111                        1111111111
1111111111111111111111111111111111           1111111111
1111111111111111111111111111111111     11111111111
 1
 1
101
 1111111111111111111111111111111111     11111111111
        1111111111111111111111111
        1000000000110000000000001
        1011000001010000000000001
        10010000000000000000000011
111111111011000001110000000000001
100000000011000001110111111111111
1111011111111101110000010001                                     111111111111111111111111111111111111
11110111111111011101010010001
11000000110101011100000010001                        11111111
10000000000000001100000010001           111111111111
100NNNNNN00000001101010010001                  11111111111111111
110000011101010111110W1111000111
11110111 1110101 101111010001         11111111111
11111111 1111111 111111111111111                        1111111111
1111111111111111111111111111111111           1111111111
1111111111111111111111111111111111     11111111111
 1
 1
101
 1